111111111111111
100000000000003
101111111111111
100000000000041
111111111111111