11111111111111111111111
10000000010000000000101
10111111010000001001001
10000000010000001100101
10110111111010100100001
10100000000010101111101
10101111101014101000001
10101000001011101010101
10101111110000001010101
10100000000001111010001
10111111111101111011101
10000000001000000010001
10010101101011101010101
10111111101010010010101
10000000001000101010101
11111111101011000010101
30000000001011111110101
11111111101000000000001
10000000001111111110101
10111111111000000000101
10001000100011111111101
10100010001000000000001
11111111111111111111111