1111111111111111111
1000000000000010001
1011111011011000101
1010100001010101101
1010001101010101101
1010111001010101101
1010100000010101101
1110101101110101101
1000100000000101101
1010101114110100001
1010100111110101111
1010110000000101003
1010101111111101011
1010000000000001011
1011101111111100011
1000001111111101011
1111100000000001011
1011111111101111101
1000000000000000001
1111111111111111111